XXXXXXXXXXXXXXXXXXXXXXXXXXXXXXXXXXXXXXXXXXXXXX
X                                      XXXXXXX
X               ä                      XXXXXXX
X                                      XXXXXXX
X                                      XXXXXXX
X                                      XXXXXXX
X                                      XXXXXXX
X                                      XXXXXXX
X                                      XXXXXXX
X                                      XXXXXXX
X                                      XXXXXXX
X                                      XXXXXXX
X                                      XXXXXXX
X                                      XXXXXXX
X                                      XXXXXXX
X                                      XXXXXXX
X                                      XXXXXXX
X                                      XXXXXXX
X                                      XXXXXXX
X                                      XXXXXXX
X                                      XXXXXXX
X                                      XXXXXXX
X                                      XXXXXXX
X                                      XXXXXXX
X                                      XXXXXXX
X                                      XXXXXXX
X                                      XXXXXXX
X                                      XXXXXXX
X                                      XXXXXXX
X                                      XXXXXXX
X                                      XXXXXXX
X                                      XXXXXXX
X                                      XXXXXXX
X                                      XXXXXXX
X                                      XXXXXXX
X                                      XXXXXXX
X                                      XXXXXXX
X                                      XXXXXXX
X                                      XXXXXXX
XXXXXXXXXXXXXXXXXXXXXXXXXXXXXXXXXXXXXXXXXXXXXX