XXXXXXXXXXXXXXXXXXXXXXXXXXXXXXXXXXXXXXXX
X                                      X
X               ä                      X
X                                      X
X                                      X
X                                      X
X                                      X
X                                      X
X                                      X
X                                      X
X                                      X
X                                      X
X                                      X
X                                      X
X                                      X
X                                      X
X                                      X
X                                      X
X                                      X
X                                      X
X                                      X
X                                      X
X                                      X
X                                      X
X                                      X
X                                      X
X                                      X
X                                      X
X                                      X
X                                      X
X                                      X
X                                      X
X                                      X
X                                      X
X                                      X
X                                      X
X                                      X
X                                      X
X                                      X
XXXXXXXXXXXXXXXXXXXXXXXXXXXXXXXXXXXXXXXX