XXXXXXXXXXXXXXXXXXXXXXXXXXXXXXXXXXXXXXXXXXXXXXXXXXXXXXXXXXXXXXXXXXXXXXXXXXXXXXXX
X                                                                 XXXXXXXXXXXXXX
X                                                                  XXXXXXXXXXXXX
X                                                                   XXXXXXXXXXXX
X                                                                    XXXXXXXXXXX
X                                                                     XXXXXXXXXX
X                                                                      XXXXXXXXX
X                                                                       XXXXXXXX
X                                                                        XXXXXXX
X                                                                         XXXXXX
X                                                                             1X
X                                                                         XXXXXX
X                                                                        XXXXXXX
X                                                                       XXXXXXXX
X                                                                      XXXXXXXXX
X                                                                     XXXXXXXXXX
X                                                                    XXXXXXXXXXX
X                                                                   XXXXXXXXXXXX
X                                                                  XXXXXXXXXXXXX
XXXXXXXXXXXXXXXXXXXXXXXXXXXXXXXXXXXXXXXXXXXXXXXXXXXXXXXXXXXXXXXXXXXXXXXXXXXXXXXX
XXXXXXXXXXXXXX                                                                 X
XXXXXXXXXXXXX                                                                  X
XXXXXXXXXXXX                                                                   X
XXXXXXXXXXX                                                                    X
XXXXXXXXXX                                                                     X
XXXXXXXXX                                                                      X
XXXXXXXX                                                                       X
XXXXXXX                                                                        X
XXXXXX                                                                         X
X1                                                                             X
XXXXXX                                                                         X
XXXXXXX                                                                        X
XXXXXXXX                                                                       X
XXXXXXXXX                                                                      X
XXXXXXXXXX                                                                     X
XXXXXXXXXXX                                                                    X
XXXXXXXXXXXX                                                                   X
XXXXXXXXXXXXX                                                                  X
XXXXXXXXXXXXXXXXXXXXXXXXXXXXXXXXXXXXXXXXXXXXXXXXXXXXXXXXXXXXXXXXXXXXXXXXXXXXXXXX