+------------------------------------------------------------------------------+
|                                                                              |
|                                                                              |
|                                                                              |
|                                                                              |
|    +--------------------------------------------------------------------+    |
|    |                                                                    |    |
|                                                                         |    |
|                                                                         |    |
|                                                                         |    |
|    |                                                                    |    |
|    |     +--------------------------------------------------------+     |    |
|    |     |                                                        |     |    |
|    |     |                                                        |     |    |
|    |     |                                                        |     |    |
|    |     |                                                        |     |    |
|    |     |                                                        |     |    |
|    |     |     +-----     ----------------------------------+     |     |    |
|    |     |     |                                            |     |     |    |
|    |     |     |                                            |     |     |    |
|    |     |     |                                            |     |     |    |
|    |     |     |                                            |     |     |    |
|    |     |     +--------------------------------------------+     |     |    |
|    |     |                                                        |     |    |
|    |     |                                                        |     |    |
|    |     |                                                        |     |    |
|    |     |                                                        |     |    |
|    |     |                                                        |     |    |
|    |     +----------------------------------------------     -----+     |    |
|    |                                                                    |    |
|    |                                                                    |    |
|    |                                                                    |    |
|    |                                                                    |    |
|    |                                                                    |    |
|    +--------------------------------------------------------------------+    |
|                                                                              |
|                                                                              |
|                                                                              |
|                                                                              |
+------------------------------------------------------------------------------+